 Mountain A Go Go Too - Captain Stridum/Naruto

Lie-Lie-Lie - DJ OZMA/Naruto

Shojo S - Scandal/Bleach

Want It All Back - Seatbelts   Mai Yamane/Cowboy Bebop

Shiny Shiny - Nirgilis/Deadman Wonderland

Trust Me - Yuuya Matsushita/Durarara

Days - FLOW/Eureka Seven

Shounen Heart - Home Made Kazoku/Eureka Seven

Anata ga ita Mori - Jyukai/Fate Stay Night

Kimi to no Ashita - Tainaka Sachi/Fate Stay Night

Happy Bivouac - The Pillows/FLCL

Kiss   Cry - Utada Hikaru/Freedom

I Will - Sowelu/Fullmetal Alchemist

Golden Time Lover - Sukima Switch/FMAB

Night of Fire - Niko/Initial D

Runnin' in the 90's - Max Coveri/Initial D

Come - Namie Amuro/Inuyasha

Preserved Roses - TM Revolution   Nana Mizuki/Valvrave

Boku Janai - Angela/Valvrave

Boku wa Koko ni Iru - Sophia/Kaleido Star

Blumenkranz - Cyua   Hiroyuki Sanada/Kill la Kill

Dirty - Nightmare/Majin Tantei Nogami Neuro

Hare Hare Yukai - Aya Hirano/Melancholy of Haruhi Suzumiya (Bonus points if you can teach everyone the actual dance.)

Hero's Come Back - Nobodyknows+/Naruto

Yurayura - Hearts Grow/Naruto

Rocks - Hound Dog/Naruto

Bacchikoi - Dev Parade/Naruto

Fly Me to the Moon - Claire/Evangelion

Breakin' Through - Shuuhei Kita/Persona~Trinity Soul

Pursuing my True Self - Shihoko Hirata/Persona 4

Beauty of Destiny - Shihoko Hirata   Lotus Juice/Persona 4

Kakeashi no Ikizama - Ataru Nakamura/Reideen

The Flame - Keiko Lee/Requiem from the Darkness

Cosmic Love - Nana Mizuki/Rosario to Vampire

Dancing in the Velvet Moon - Nana Mizuki/Rosario to Vampire

Reckless Fire - Ide Yasuaki/s-CRY-ed

Battlecry - Nujabes   Shing02/Samurai Champloo

Shiki no Uta - Minmi/Samurai Champloo

Koiji Romanesque - Zetsubou Shoujotachi/Sayonara Zetsubou Sensei

Comic Sonic - The Pillows/Sket Dance

Give a Reason - Megumi Hayashibara/Slayers NEXT

Jama wa Sasenai - Masami Okui/Slayers NEXT

Down Town - Maaya Sakamoto/Soredemo Machi wa Mawatteiru

Resonance - TM Revolution/Soul Eater

Light of Dawn - Annabel/Tatakau Shisho: The Book of Bantorra

PSI-Missing - Mami Kawada/Toaru Majutsu no Index

Masterpiece - Mami Kawada/Toaru Majutsu no Index S2

Forever We Can Make It - Thyme/To Love Ru

Dress (Blood Trinity Mix) - Buck-Tick/Trinity Blood

Feel So Moon - Unicorn/Uchuu Kyoudai

Trust - Salia/Vandread S1

Himegoto - SiLC/Vandread S1

Justice - Aki Kudou/Vandread S2

Puzzle - Round Table feat. Nino/Welcome to the NHK

Zero - AAA/Sekai Bokumetsu no Rokunin

Secret Sorrow - Kohei Koizumi/X-1999

19-Sai - Suga Shikao/xxxHolic

Reason - Fotogenico/xxxHolic

Nobody Knows - Suga Shikao/xxxHolic S2

Honey Honey - Seamo/xxxHolic S2

(Just for Giggles)

Libera Me From Hell - Taku Iwasaki/Gurren Lagann 




